Brennessel	nn	nnn
Brennesseln	nn	nnn
Delphin	ph	f
Delphins	ph	f
Delphine	ph	f
Delphinen	ph	f
Delphinschwimmen	ph	f
Delphinschwimmens	ph	f
Differential	tial	zial
Differentiale	tial	zial
Differentialen	tial	zial
Differentials	tial	zial
Differentiales	tial	zial
essenziell	zie	tie
essenzielle	zie	tie
essenziellem	zie	tie
essenziellen	zie	tie
essenzieller	zie	tie
essenzielles	zie	tie
Gemse	Ge	Gä
Gemsen	Ge	Gä
Greuel	eu	äu
Greueln	eu	äu
Greuels	eu	äu
Joghurt	gh	g
Joghurts	gh	g
Känguruh	ruh	ru
Känguruhs	ruh	ru
Karamel	l	ll
Karamels	l	ll
Ketchup	ch	sch
Ketchups	ch	sch
Kommunique	que	kee
Kommuniques	que	kee
Numerieren	m	mm
Numerierende	m	mm
Numerierenden	m	mm
Numerierens	m	mm
Numerierte	m	mm
Numerierten	m	mm
Numerierung	m	mm
Numerierungen	m	mm
numeriere	m	mm
numerieren	m	mm
numerierend	m	mm
numerierende	m	mm
numerierendem	m	mm
numerierenden	m	mm
numerierender	m	mm
numerierendes	m	mm
numerierest	m	mm
numerieret	m	mm
numerierst	m	mm
numeriert	m	mm
numerierte	m	mm
numeriertem	m	mm
numerierten	m	mm
numerierter	m	mm
numeriertes	m	mm
numeriertest	m	mm
numeriertet	m	mm
Panther	th	t
Panthern	th	t
Panthers	th	t
plazieren	z	tz
plazierend	z	tz
plazierende	z	tz
plazierendem	z	tz
plazierenden	z	tz
plazierender	z	tz
plazierendes	z	tz
Portemonnaie	emonnaie	monee
Portemonnaies	emonnaie	monee
potentiell	tiell	ziell
potentielle	tiell	ziell
potentiellem	tiell	ziell
potentiellen	tiell	ziell
potentieller	tiell	ziell
potentiellere	tiell	ziell
potentiellerem	tiell	ziell
potentielleren	tiell	ziell
potentiellerer	tiell	ziell
potentielleres	tiell	ziell
potentielles	tiell	ziell
potentiellste	tiell	ziell
potentiellstem	tiell	ziell
potentiellsten	tiell	ziell
potentiellster	tiell	ziell
potentiellstes	tiell	ziell
Saxophon	ph	f
Saxophone	ph	f
Saxophonen	ph	f
Saxophons	ph	f
Saxofonist	f	ph
Saxofonisten	f	ph
selbständig	selbst	selbstst
selbständige	selbst	selbstst
selbständigem	selbst	selbstst
selbständigen	selbst	selbstst
selbständiger	selbst	selbstst
selbständigere	selbst	selbstst
selbständigerem	selbst	selbstst
selbständigeren	selbst	selbstst
selbständigerer	selbst	selbstst
selbständigeres	selbst	selbstst
selbständiges	selbst	selbstst
selbständigste	selbst	selbstst
selbständigstem	selbst	selbstst
selbständigsten	selbst	selbstst
selbständigster	selbst	selbstst
selbständigstes	selbst	selbstst
Stengel	eng	äng
Stengeln	eng	äng
Stengels	eng	äng
Stop	p	pp
Stopwort	p	pp
Stopworte	p	pp
Stopwortes	p	pp
Stopworts	p	pp
Stopwörter	p	pp
Stopwörtern	p	pp
substantiell	tiell	ziell
substantielle	tiell	ziell
substantiellem	tiell	ziell
substantiellen	tiell	ziell
substantieller	tiell	ziell
substantielles	tiell	ziell
Thunfisch	Th	T
Thunfische	Th	T
Thunfischen	Th	T
Thunfisches	Th	T
Thunfischs	Th	T
Tip	p	pp
Tips	p	pp
Variete	te	tee
Varietes	te	tee
Waggon	gg	g
Waggons	gg	g
